11 5 4 4 4 4 4 4 4 4 4 4 4 4 4 6 14 
11 10 0 0 0 0 0 0 0 0 0 0 0 0 0 13 14 
11 10 0 0 0 0 0 0 0 0 0 0 0 0 0 13 14 
11 10 0 0 0 0 0 0 0 0 0 0 0 0 0 13 14 
11 10 0 0 0 0 0 0 0 0 0 0 0 0 0 13 14 
11 10 0 0 0 0 0 0 0 0 0 0 0 0 0 13 14 
11 10 0 0 0 0 0 0 0 0 0 0 0 0 0 13 14 
11 10 0 0 0 0 0 0 0 0 0 0 0 0 0 13 14 
11 10 0 0 0 0 0 0 0 0 0 0 0 0 0 13 14 
11 10 0 0 0 0 0 0 0 0 0 0 0 0 0 13 14 
11 10 0 0 0 0 0 0 0 0 0 0 0 0 0 13 14 
11 10 0 0 0 0 0 0 0 0 0 0 0 0 0 13 14 
12 8 7 7 7 7 7 7 7 7 7 7 7 7 7 9 15 